County,obamavote,romneyvote,totalvote,obama,romney
ADAMS,9648,20416,30064,0.320915381,0.679084619
ALEXANDER,1965,1487,3452,0.569235226,0.430764774
BOND,3020,4095,7115,0.424455376,0.575544624
BOONE,9883,11096,20979,0.471090138,0.528909862
BROWN,787,1513,2300,0.342173913,0.657826087
BUREAU,8134,8164,16298,0.499079642,0.500920358
CALHOUN,1080,1440,2520,0.428571429,0.571428571
CARROLL,3665,3555,7220,0.507617729,0.492382271
CASS,2053,2707,4760,0.431302521,0.568697479
CHAMPAIGN,40831,35312,76143,0.53624102,0.46375898
CHRISTIAN,5494,8885,14379,0.382084985,0.617915015
CLARK,2591,5144,7735,0.334970911,0.665029089
CLAY,1584,4190,5774,0.274333218,0.725666782
CLINTON,5596,10524,16120,0.347146402,0.652853598
COLES,9262,11631,20893,0.443306371,0.556693629
COOK,1488537,495542,1984079,0.750240792,0.249759208
CRAWFORD,2858,5585,8443,0.338505271,0.661494729
CUMBERLAND,1641,3509,5150,0.318640777,0.681359223
DOUGLAS,2430,5334,7764,0.312982998,0.687017002
DeKALB,21207,18934,40141,0.528312698,0.471687302
DeWITT,2601,4579,7180,0.362256267,0.637743733
DuPAGE,199460,195046,394506,0.505594338,0.494405662
EDGAR,2565,5132,7697,0.33324672,0.66675328
EDWARDS,754,2405,3159,0.238683128,0.761316872
EFFINGHAM,3861,12501,16362,0.235973597,0.764026403
FAYETTE,2853,5951,8804,0.324057247,0.675942753
FORD,1656,4229,5885,0.281393373,0.718606627
FRANKLIN,7254,10267,17521,0.414017465,0.585982535
FULTON,8328,6632,14960,0.556684492,0.443315508
GALLATIN,1029,1492,2521,0.408171361,0.591828639
GREENE,2023,3451,5474,0.369565217,0.630434783
GRUNDY,9451,11343,20794,0.454506108,0.545493892
HAMILTON,1269,2566,3835,0.330899609,0.669100391
HANCOCK,3650,5271,8921,0.409146957,0.590853043
HARDIN,742,1535,2277,0.325867369,0.674132631
HENDERSON,1978,1541,3519,0.562091503,0.437908497
HENRY,12332,11583,23915,0.515659628,0.484340372
IROQUOIS,3413,9120,12533,0.272321072,0.727678928
JACKSON,13319,9864,23183,0.574515809,0.425484191
JASPER,1436,3514,4950,0.29010101,0.70989899
JEFFERSON,6089,9811,15900,0.382955975,0.617044025
JERSEY,3667,6039,9706,0.377807542,0.622192458
JOHNSON,1572,3963,5535,0.28401084,0.71598916
JoDAVIESS,5667,5534,11201,0.50593697,0.49406303
KANE,90332,88335,178667,0.505588609,0.494411391
KANKAKEE,21595,23136,44731,0.482774809,0.517225191
KENDALL,22471,24047,46518,0.483060321,0.516939679
KNOX,13451,9408,22859,0.58843344,0.41156656
LAKE,153757,129764,283521,0.542312562,0.457687438
LAWRENCE,2011,3857,5868,0.342706203,0.657293797
LEE,6937,8059,14996,0.462590024,0.537409976
LIVINGSTON,5020,9753,14773,0.339809111,0.660190889
LOGAN,3978,7844,11822,0.336491287,0.663508713
LaSALLE,23073,23256,46329,0.498024995,0.501975005
MACON,22780,25309,48089,0.473705005,0.526294995
MACOUPIN,9464,10946,20410,0.463694268,0.536305732
MADISON,58922,60608,119530,0.492947377,0.507052623
MARION,6225,9248,15473,0.402313708,0.597686292
MARSHALL,2455,3290,5745,0.427328111,0.572671889
MASON,2867,3265,6132,0.467547293,0.532452707
MASSAC,2092,4278,6370,0.328414443,0.671585557
MENARD,2100,3948,6048,0.347222222,0.652777778
MERCER,4507,3876,8383,0.537635691,0.462364309
MONROE,6215,10888,17103,0.36338654,0.63661346
MONTGOMERY,5058,6776,11834,0.42741254,0.57258746
MORGAN,5806,7972,13778,0.421396429,0.578603571
MOULTRIE,2144,3784,5928,0.361673414,0.638326586
McDONOUGH,5967,6147,12114,0.492570579,0.507429421
McHENRY,59797,71598,131395,0.455093421,0.544906579
McLEAN,31883,39947,71830,0.443867465,0.556132535
OGLE,9514,13422,22936,0.414806418,0.585193582
PEORIA,40209,36774,76983,0.52231012,0.47768988
PERRY,3819,5507,9326,0.409500322,0.590499678
PIATT,3090,5413,8503,0.363401153,0.636598847
PIKE,2278,4860,7138,0.319137013,0.680862987
POPE,650,1512,2162,0.300647549,0.699352451
PULASKI,1389,1564,2953,0.470369116,0.529630884
PUTNAM,1559,1502,3061,0.509310683,0.490689317
RANDOLPH,5759,8290,14049,0.409922414,0.590077586
RICHLAND,2362,4756,7118,0.331834785,0.668165215
ROCK ISLAND,39157,24934,64091,0.610959417,0.389040583
SALINE,3701,6806,10507,0.352241363,0.647758637
SANGAMON,42107,50225,92332,0.456039076,0.543960924
SCHUYLER,1727,2069,3796,0.454952582,0.545047418
SCOTT,910,1587,2497,0.364437325,0.635562675
SHELBY,3342,6843,10185,0.328129602,0.671870398
ST. CLAIR,67285,50125,117410,0.573077251,0.426922749
STARK,1095,1528,2623,0.417460923,0.582539077
STEPHENSON,10165,10512,20677,0.491609034,0.508390966
TAZEWELL,24438,35335,59773,0.408846804,0.591153196
UNION,3137,4957,8094,0.38757104,0.61242896
VERMILION,12878,16892,29770,0.432583137,0.567416863
WABASH,1590,3478,5068,0.313733228,0.686266772
WARREN,4044,3618,7662,0.52779953,0.47220047
WASHINGTON,2450,4792,7242,0.338304336,0.661695664
WAYNE,1514,5988,7502,0.20181285,0.79818715
WHITE,2188,4731,6919,0.316230669,0.683769331
WHITESIDE,14833,10448,25281,0.586725209,0.413274791
WILL,144229,128969,273198,0.527928462,0.472071538
WILLIAMSON,10647,17909,28556,0.372846337,0.627153663
WINNEBAGO,61732,55138,116870,0.528210833,0.471789167
WOODFORD,5572,12961,18533,0.300652889,0.699347111